%%%%%%%
% P.  %
%.%%% %
%  .  %
% %%%.%
%. G  %
%%%%%%%